R 800 600
NO textures
SO text
WE textures/wall_3.xpm
EA textures/wall_4.xpm
S textures/sprite_1.xpm

F 184,113,39
C 51,198,227

1111111111
111111111000011111