R 100000                       2000

NO textures


SO                     text


          WE                                 textures/wall_3.xpm




  EA textures/wall_4.xpm

S                                                    textures/sprite_1.xpm
F 184    ,      113,   39 
C 51   ,   198,   255

        1111111111111111111111111
        1000000000110000000000001
        1011E00001110000002000001
        10010000000000000000000011111111
        111111111011000001110000000000001111111
        111111111111111111000000011000000000001
    1   111101111111110111000000100011111111111
111101111111110111010100100011111111
110000101101010111000000100011111111
100020000000000011000000100011
100000000000000011010100100001
110000011101010111101111001111
11110111 1110101 1011110100011
11111111 1111111 1111111111111
