R 642982 516464

NO ./textures/brick.xpm
SO ./textures/blue.xpm
WE ./textures/wood.xpm
EA ./textures/grey.xpm

S ./textures/barrel.xpm
F 100,0,100
C 0,0,0

1111111111
111111111000011111
1111111111
11111111111
11111111111
1111
1111111111
1111111
11111111111
11111111211111
